#######
#     #
#o@@ x#
#     #
#######
